1
1
0
39
38
0
1111111111111111111111111111111111111111
1200000000000000000000000000000000000001
1000000000000000000000000000000000011101
1001111111111001000000001111111000000101
1001000000000001000000001100011000000101
1001001111110011000000001000001001100001
1100000000010010000000001100011000000001
1000000000010010000000001111111000000001
1000000000010010000000000000100000000001
1000001111110011111111111001100000000001
1000001000000010000000000000100000000001
1000001000000100011111111100000000000001
1000001000001000000000000000000000000001
1000010000001000000000000000000000000001
1000010001111111111111111111100000001001
1000010001300000000000000003100000001001
1000010001000000010010000000100000001001
1000010001000100010010001000111111111001
1000010000000100010010001000000000000001
1000010000000100010010001000000000000001
1000011111000100010010001000111111111001
1000000001000000010010000000100000001001
1000000001001110000000011100100000001001
1001000001000000000000000000100000001001
1001110001111111111111111111100000001001
1000000000000000000000000000000000001001
1000000000000000000000000000000111111001
1001110000000000001000000000000100000001
1001000011111000001000000000000100000001
1000000000100000001001111111111111111001
1000000000100000001000000000000000000001
1000000000100000001000000000000000000001
1000001111111111100011111111111111000001
1000000000000000001000000010000000000001
1000000000000000001000000010000000000001
1000001111111111001000000010000000000001
1000000000000001001000001111100000000001
1001111111110001001000000000000000000001
1000000000000000000000000000000000000001
1000000000000000000000000000000000000021
1111111111111111111111111111111111111111
111111111111111111111111111111
100000000000000000000000000001
100000000000000000100000000001
100111000100000000100001100111
100010000100000000000001100111
100000000111111111100000000001
100001000000000000000110011001
100011100001000000000110011001
100000000001000010000000000001
100000000001000010000000000001
100001111111000011111111110001
100000000000000000000000000001
100000000000000000000000000001
100001111111000010000011000001
100000000001000010000011000001
100000000111000010000011000001
100001001300000000000011001011
100000101000001000000011001311
100001101100001000000001001111
100111101111001000010000100001
100000000000001000010000010001
100111101111001000010000001001
100001101100001001111111000101
100000101000001000000000000101
100001000100001100000011111101
100000000000000111110010000001
100000000000000000000000011111
111111111111111011111111110001
100000000000000000000000000001
111111111111111111111111111111
0.0
0.0
0.0
0.0
0.0